------------------------------------------------------------------------------------------------------------------------
------------------------------------------------------------------------------------------------------------------------
------------------------------------------------------------------------------------------------------------------------
------------------------------------------------------------------------------------------------------------------------
------------------------------------------------------------------------------------------------------------------------
-------------m----WWWWWWWWWWWWWWWWWWWWWWWWWWWWWWWWWWWWWWWWWWWWWWWWWWWWWWWWWWWWWWWWWWWWWWWWWWWWWWWWWWWWWWWWWW------------
-------------------m--------------------------------------r------------------------------------------------W------------
------------W----------------------------------------------------------------------------------------------W------------
------------Wm-------------------------------------------R--r----------------------------------------------W------------
------------W----------------------------------------------------------------------------------------------W------------
------------W---------------------------------------------r------------------------------------------------W------------
------------WWWWWWWWWWWWWWWWWWWWWWWWWWWWWWWWWWWWWWWWWWWWWWWWWWWWWWWWWWWWWWWWWWWWWWWWWWWWWWWWWWWWWWWW-------W------------
------------W------------------------r-----------W-------------------------------------------------W-------W------------
------------W-----------------M---------------r--W--------------------WWWWWWWWW--------------------W-------W------------
------------W------------------------------------W----------------WWWW---------WWWW----------------W-------W------------
------------W-------W--------mm------------------W-------------WWW--------c--------WWW-------------W-------W------------
------------W-------W----------------------------W----------WWW---m---------------m---WWW----------W-------W------------
------------W-------Wr--------------r------------W--------WWW---------------------------WWW--------W---M---W------------
------------W-------W---------------------------mW------WWW-------------------------------WWW------W-------W------------
---------S--W---R---W--r----------M--------------W-----WWW---------------------------------WWW-----W-------W------------
------------W-------W---------------------m------W----WWW-----------------------------------WWW----W-------W------------
------------W-------WWWWWWWWWWWWWWWWWWWWWWWWW----W---WWW-------------------------------------WWW---W-------W------------
------------W-------W----------------------------W---WWW-------------------------------------WWW---W---m---W------------
------------W--m-m--W----WWWWWWWWWWWWWWWWWWWWWWWWW---WWW-------------------------------------WWW---W-m---m-W------------
------------W-m---m-W---m---------r--------------W---WWW-------------------------------------WWW---W---m---W------------
------------W-m---m-W-mm-------------------------W---WWW-------------------------------------WWW---W-------W------------
------------W--m-m--W----------------------r-----W----WWW-----------------------------------WWW----W-------W------------
------------W---m---W----------r-----------------W-----WWW---------------------------------WWW-----W-------W------------
------------W-------Wr------r--------------------W------WWW-------------------------------WWW------W-------W------------
------------W-m---m-W-------------M------m-------W--------WWW-----r---------------r-----WWW--------W-------W------------
------------W-m---m-W------------------m---------W----------WWW-----------------------WWW----------W---M---W------------
------------W-m---m-W-----------------m----------W-------------WWW-----------------WWW-------------W-------W------------
------------W-------W---r------M-----m-----------W-------R--------WWWW---------WWWW--------R-------W-------W------------
------------W---m---W----------------------------W--R-------------------------------------------R--W-------W------------
------------W-------W---------r--------------r---W-------------------------------------------------W-------W------------
------------W-------W------------------------m-----------------------------------------------------W-------W------------
------------W---R---W------r------r----------------------------------------------------------------W-------W------------
------------W-------W---------------------m--------------------------------------------------------W-------W------------
------------W-------WWWWWWWWWWWWWWWWWWWWWWWWWWWWWWWWWWWWWWWWWWWWWWWWWWWWWWWWWWWWWWWWWWWWWWWWWWWWWWWW-------W------------
------------W-------------------------------------r---------r---------r------------------------------------W------------
------------W----------------------------------------------------------------------------------------------W------------
------------W-----------------R-----------------------------r-----------------------------R----------------W------------
------------W----------------------------------------------------------------------------------------------W------------
------------W-------------------------------------r---------r---------r------------------------------------W------------
------------WWWWWWWWWWWWWWWWWWWWWWWWWWWWWWWWWWWWWWWWWWWWWWWWWWWWWWWWWWWWWWWWWWWWWWWWWWWWWWWWWWWWWWWWWWWWWWWW------------
------------------------------------------------------------------------------------------------------------------------
------------------------------------------------------------------------------------------------------------------------
------------------------------------------------------------------------------------------------------------------------
------------------------------------------------------------------------------------------------------------------------
------------------------------------------------------------------------------------------------------------------------